The Maltese Corsairs
An Interactive Fiction
Release 1 / Serial number 100218 / Inform 7 build 5Z71 (I6/v6.31 lib 6/12N) SD

Hold
On some occasions, the hold is an empty cavern full of not much beside the sound of waves.  Not this week, though.  Crates and crates--of cinnamon, of all things--line the bulkheads, leaving only a narrow path aft to the brig from the stair leading up to the crew quarters.

I beg your pardon?

9:00 am

>z
Time passes.

9:01 am

>wait till 10:00 am
I only understood you as far as wanting to wait.

9:01 am

>wait till 10:00 am
I only understood you as far as wanting to wait.

9:01 am

>wait until 10:00 am
I only understood you as far as wanting to wait.

9:01 am

>wait 15
I only understood you as far as wanting to wait.

9:01 am

>wai
That's not a verb I recognize.

9:01 am

>wait
Time passes.

9:02 am

>z
Time passes.

9:03 am

>z
Time passes.

9:04 am

>s
[You can't go that way, amico.  It looks like you can only go up and aft.]

9:05 am

>aft
Brig
It's a small room, with a barred cell that takes up half of it.  The walls are a dingy white and the small lamp at the guard's desk doesn't do much to enliven the place.   We don't normally deal in prisoners, so most of the time brig duty is just a chance to sneak in an extra shift of sleep.

Suede sits at the guard's desk, playing solitaire.

9:06 am

* * *

The Maltese Corsairs
An Interactive Fiction
Release 1 / Serial number 100218 / Inform 7 build 5Z71 (I6/v6.31 lib 6/12N) SD

Hold
On some occasions, the hold is an empty cavern full of not much beside the sound of waves.  Not this week, though.  Crates and crates--of cinnamon, of all things--line the bulkheads, leaving only a narrow path aft to the brig from the stair leading up to the crew quarters.

>up
up
Crew Quarters
A row of hammocks line the berth deck along the starboard side, which curves to create a moderately open space.  A curtained alcove off the opposite side secludes the cannon master's bed from casual view. You still haven't been able to figure out why the captain won't set up cabins for everyone. 

If you need to hit the head, the door is on the fore wall; the mess is aft, and stairs lead down to the hold and up to the Cannons.

Fiordaliso is asleep in his hammock.

>up
up
Cannons
The gun deck is long with a low ceiling, lit only by dim shafts of sunlight falling on rows of cannons aimed outwards.

Stairs lead down to the crew quarters and up to the deck.

>up
up
Deck
The sea stretches out in every direction... but you're standing on the deck of the Joli, which feels cramped by comparison. (You never did get the hang of how much smaller life aboard ship is.) The entrance to the captain's hall is aft, and the deck extends in the opposite direction to the fo'c'sle.  You could also climb up to the crows' nest, or go down to the Cannons.

>up
up
Crows' Nest
The view from the crow's nest is impressive--the blue-green sea in every direction, and the deck below mostly obscured by the rigging.   Unfortunately it's a tiny space in and of itself, which makes you despise every second duty keeps you up here.

Iigo sits here, keeping watch.,

>x iigo
The day lookout is probably the one  Corsair you find most like yourself: sort of an everyday tiger, the sort you wouldn't expect to find on a pirate ship.  He's taken to it a lot better than you have so far though.

>x inigo
You can't see any such thing.

>exit
But you aren't in anything at the moment.

>quit
Are you sure you want to quit?

* * *

>up
up
Crows' Nest
The view from the crow's nest is impressive--the blue-green sea in every direction, and the deck below mostly obscured by the rigging.   Unfortunately it's a tiny space in and of itself, which makes you despise every second duty keeps you up here.

Iigo sits here, keeping watch.,

>bacon
baconThat's not a verb I recognize.

* * *

>up
up
Deck
The sea stretches out in every direction... but you're standing on the deck of the Joli, which feels cramped by comparison. (You never did get the hang of how much smaller life aboard ship is.) The entrance to the captain's hall is aft, and the deck extends in the opposite direction to the fo'c'sle.  You could also climb up to the crows' nest, or go down to the Cannons.

>aft
Captain's Hall
The captain generally keeps all his equipment here, more likely than not stacked at random on the grand table at the center of the room.  The walls are also bedecked with miscellany finds from the ship's travels, including a shelf with a radio that won't be useful for another hundred years or so.  The captain's quarters are to starboard and the first mate's to port.

>in
[You can enter the captain's quarters starboard, or the first mate's quarters port.]

>w
[You can enter the captain's quarters starboard, or the first mate's quarters port.]

>x me
You're Jean Waring, a blue tiger.  Folk said you'd never be man enough to be a pirate, but here you are.

>x hands
You can't see any such thing.

* * *

>up
up
Crew Quarters
A row of hammocks line the berth deck along the starboard side, which curves to create a moderately open space.  A curtained alcove off the opposite side secludes the cannon master's bed from casual view. You still haven't been able to figure out why the captain won't set up cabins for everyone. 

If you need to hit the head, the door is on the fore wall; the mess is aft, and stairs lead down to the hold and up to the Cannons.

Fiordaliso is asleep in his hammock.

>n
Head

>s
Crew Quarters

>s
Mess

>s
Galley

>u
You can't go that way.

>n
Mess

>n
Crew Quarters

>u
Cannons

>n
You can't go that way.

>u
Deck

>n
Poop

>s
Deck

>e
Lifeboat

>w
Deck

>s
Captain's Hall

>e
Captain's Quarters

>w
Captain's Hall

>w
First Mate's Quarters

>e
Captain's Hall

>n
Deck

>purloin all
(the Deck)
[Can't move Deck: it would contain itself.]

>about
That's not a verb I recognize.

>help
That's not a verb I recognize.

* * *

>up
up
Crew Quarters
A row of hammocks line the berth deck along the starboard side, which curves to create a moderately open space.  A curtained alcove off the opposite side secludes the cannon master's bed from casual view. You still haven't been able to figure out why the captain won't set up cabins for everyone. 

If you need to hit the head, the door is on the fore wall; the mess is aft, and stairs lead down to the hold and up to the Cannons.

Fiordaliso is asleep in his hammock.

>l fiordaliso
I only understood you as far as wanting to look.

>x fiordaliso
You see nothing special about Fiordaliso.

>a
Mess
A pair of long tables are the main feature of the mess. You can probably count on one hand the number of times the whole crew has sat down to eat together, though. Rock generally leaves a plate or pot of something out for folk, and today is no exception.

>a
Galley
The ship's kitchen is not very large, and the presence of the cook generally leaves it much more cramped.  Cabinets line the upper and lower walls, and a small bench sits by the entrance, fore.

The cook is a good three hundred fifty pounds, and it's easy to see why--he never does seem to stop eating.  He makes good food, all right, but he hasn't got the most pleasant personality; he'll throw you out of the mess for the slightest thing.

>x roquefort
You see nothing special about Roquefort.

* * *

The Maltese Corsairs
An Interactive Fiction
Release 1 / Serial number 100218 / Inform 7 build 5Z71 (I6/v6.31 lib 6/12N) SD

Hold
On some occasions, the hold is an empty cavern full of not much beside the sound of waves.  Not this week, though.  Crates and crates--of cinnamon, of all things--line the bulkheads, leaving only a narrow path aft to the brig from the stair leading up to the crew quarters.

>z.z.z.z.z.z.z.z.z.z.
Time passes.

Time passes.

Time passes.

Time passes.

Time passes.

Time passes.

Time passes.

Time passes.

Time passes.

Time passes.

9:10 am

>z.z.z.z.z.z.z.z.z.z.
Time passes.

Time passes.

Time passes.

Time passes.

Time passes.

Time passes.

Time passes.

Time passes.

Time passes.

Time passes.

9:20 am

>z.z.z.z.z.z.z.z.z.z.
Time passes.

Time passes.

Time passes.

Time passes.

Time passes.

Time passes.

Time passes.

Time passes.

Time passes.

Time passes.

9:30 am

>z.z.z.z.z.z.z.z.z.z.
Time passes.

Time passes.

Time passes.

Time passes.

Time passes.

Time passes.

Time passes.

Time passes.

Time passes.

Time passes.

9:40 am

>z.z.z.z.z.z.z.z.z.z.
Time passes.

Time passes.

Time passes.

Time passes.

Time passes.

Time passes.

Time passes.

Time passes.

Time passes.

Time passes.

9:50 am

>z.z.z.z.z.z.z.z.z.z.
Time passes.

Time passes.

Time passes.

Time passes.

Time passes.

Time passes.

Time passes.

Time passes.

Time passes.

Time passes.

10:00 am

>z.z.z.z.z.z.z.z.z.z.
Time passes.

Time passes.

Time passes.

Time passes.

Time passes.

Time passes.

Time passes.

Time passes.

Time passes.

Time passes.

10:10 am

>z.z.z.z.z.z.z.z.z.z.
Time passes.

Time passes.

Time passes.

Time passes.

Time passes.

Time passes.

Time passes.

Time passes.

Time passes.

Time passes.

10:20 am

>z.z.z.z.z.z.z.z.z.z.
Time passes.

Time passes.

Time passes.

Time passes.

Time passes.

Time passes.

Time passes.

Time passes.

Time passes.

Time passes.

10:30 am

>z.z.z.z.z.z.z.z.z.z.
Time passes.

Time passes.

Time passes.

Time passes.

Time passes.

Time passes.

Time passes.

Time passes.

Time passes.

Time passes.

10:40 am

>z.z.z.z.z.z.z.z.z.z.
Time passes.

Time passes.

Time passes.

Time passes.

Time passes.

Time passes.

Time passes.

Time passes.

Time passes.

Time passes.

10:50 am

>z.z.z.z.z.z.z.z.z.z.
Time passes.

Time passes.

Time passes.

Time passes.

Time passes.

Time passes.

Time passes.

Time passes.

Time passes.

Time passes.

11:00 am

>z.z.z.z.z.z.z.z.z.z.
Time passes.

Time passes.

Time passes.

Time passes.

Time passes.

Time passes.

Time passes.

Time passes.

Time passes.

Time passes.

11:10 am

>z.z.z.z.z.z.z.z.z.z.
Time passes.

Time passes.

Time passes.

Time passes.

Time passes.

Time passes.

Time passes.

Time passes.

Time passes.

Time passes.

11:20 am

I beg your pardon?

11:20 am

I beg your pardon?

11:20 am

>z.z.z.z.z.z.z.z.z.z.
Time passes.

Time passes.

Time passes.

Time passes.

Time passes.

Time passes.

Time passes.

Time passes.

Time passes.

Time passes.

11:30 am

>z.z.z.z.z.z.z.z.z.z.
Time passes.

Time passes.

Time passes.

Time passes.

Time passes.

Time passes.

Time passes.

Time passes.

Time passes.

Time passes.

11:40 am

>z.z.z.z.z.z.z.z.z.z.
Time passes.

Time passes.

Time passes.

Time passes.

Time passes.

Time passes.

Time passes.

Time passes.

Time passes.

Time passes.

11:50 am

>z.z.z.z.z.z.z.z.z.z.
Time passes.

Time passes.

Time passes.

Time passes.

Time passes.

Time passes.

Time passes.

Time passes.

Time passes.

Time passes.

12:00 pm

>z.z.z.z.z.z.z.z.z.z.
Time passes.

Time passes.

Time passes.

Time passes.

Time passes.

Time passes.

Time passes.

Time passes.

Time passes.

Time passes.

12:10 pm

I beg your pardon?

12:10 pm

I beg your pardon?

12:10 pm

>z.z.z.z.z.z.z.z.z.z.
Time passes.

Time passes.

Time passes.

Time passes.

Time passes.

Time passes.

Time passes.

Time passes.

Time passes.

Time passes.

12:20 pm

>z.z.z.z.z.z.z.z.z.z.
Time passes.

Time passes.

Time passes.

Time passes.

Time passes.

Time passes.

Time passes.

Time passes.

Time passes.

Time passes.

12:30 pm

>z.z.z.z.z.z.z.z.z.z.
Time passes.

Time passes.

Time passes.

Time passes.

Time passes.

Time passes.

Time passes.

Time passes.

Time passes.

Time passes.

12:40 pm

>z.z.z.z.z.z.z.z.z.z.
Time passes.

Time passes.

Time passes.

Time passes.

Time passes.

Time passes.

Time passes.

Time passes.

Time passes.

Time passes.

12:50 pm

* * *

The Maltese Corsairs
An Interactive Fiction
Release 1 / Serial number 100218 / Inform 7 build 5Z71 (I6/v6.31 lib 6/12N) SD

Hold
On some occasions, the hold is an empty cavern full of not much beside the sound of waves.  Not this week, though.  Crates and crates--of cinnamon, of all things--line the bulkheads, leaving only a narrow path aft to the brig from the stair leading up to the crew quarters.

>i
You are carrying nothing.

>purloin zac
[Purloined.]

>i
You are carrying:
  Zac

>drop zac
Dropped.

>x zac
The cabin boy is an older teenager, awkward in his movements, but he's a sharp young tiger, and strong enough to handle the odd jobs he gets thrown every day.

>aft
Brig
It's a small room, with a barred cell that takes up half of it.  The walls are a dingy white and the small lamp at the guard's desk doesn't do much to enliven the place.   We don't normally deal in prisoners, so most of the time brig duty is just a chance to sneak in an extra shift of sleep.

Suede sits at the guard's desk, playing solitaire.

>x suede
The day guard is a lean and bored-looking fellow, a dark blue tiger with a habit of wearing a short-brimmed visor to shade his eyes, even in the dimness below decks.

>suede, hello
There is no reply.

>kiss suede
Keep your mind on the game.

>lewd
That's not a verb I recognize.

>down
[You can't go that way, amico.  It looks like you can only go fore.]

>sleep
You aren't feeling especially drowsy.

>z
Time passes.

* * *

>z
That's not a verb I recognize.

>x me
You're Jean Waring, a blue tiger.  Folk said you'd never be man enough to be a pirate, but here you are.

>dance
That's not a verb I recognize.

>sit
(on Suede)
That's not something you can sit down on.

>l
Brig
It's a small room, with a barred cell that takes up half of it.  The walls are a dingy white and the small lamp at the guard's desk doesn't do much to enliven the place. 

Suede sits at the guard's desk, playing solitaire.

>sit at desk
I didn't understand that sentence.

>x desk
You can't see any such thing.

>? what
That's not a verb I recognize.

>f
Hold
You can see Zac here.

>u
Crew Quarters
A row of hammocks line the berth deck along the starboard side, which curves to create a moderately open space.  A curtained alcove off the opposite side secludes the cannon master's bed from casual view. You still haven't been able to figure out why the captain won't set up cabins for everyone. 

If you need to hit the head, the door is on the fore wall; the mess is aft, and stairs lead down to the hold and up to the Cannons.

Fiordaliso is asleep in his hammock.

Laszlo is snoring loudly, asleep in his hammock.

* * *

The Maltese Corsairs
An Interactive Fiction
Release 1 / Serial number 100218 / Inform 7 build 5Z71 (I6/v6.31 lib 6/12N) SD

Hold
On some occasions, the hold is an empty cavern full of not much beside the sound of waves.  Not this week, though.  Crates and crates--of cinnamon, of all things--line the bulkheads, leaving only a narrow path aft to the brig from the stair leading up to the crew quarters.

>z.z.z.z.z.z.z.z.z.z.z.z.z.z.z.z.z.z.z.z.z.z.z.z.z.z.z.z.z
Time passes.

Time passes.

Time passes.

Time passes.

Time passes.

Time passes.

Time passes.

Time passes.

Time passes.

Time passes.

Time passes.

Time passes.

Time passes.

Time passes.

Time passes.

Time passes.

Time passes.

Time passes.

Time passes.

Time passes.

Time passes.

Time passes.

Time passes.

Time passes.

Time passes.

Time passes.

Time passes.

Time passes.

Time passes.

9:29 am

>z
Time passes.

9:30 am

>z.z.z.z.z.z.z.z.z.z.z.z.z.z.z.z.z.z.z.z.z.z.z.z.z.z.z.z.z
Time passes.

Time passes.

Time passes.

Time passes.

Time passes.

Time passes.

Time passes.

Time passes.

Time passes.

Time passes.

Time passes.

Time passes.

Time passes.

Time passes.

Time passes.

Time passes.

Time passes.

Time passes.

Time passes.

Time passes.

Time passes.

Time passes.

Time passes.

Time passes.

Time passes.

Time passes.

Time passes.

Time passes.

Time passes.

9:59 am

>z
Time passes.

10:00 am

>z.z.z.z.z.z.z.z.z.z.z.z.z.z.z.z.z.z.z.z.z.z.z.z.z.z.z.z.z.z
Time passes.

Time passes.

Time passes.

Time passes.

Time passes.

Time passes.

Time passes.

Time passes.

Time passes.

Time passes.

Time passes.

Time passes.

Time passes.

Time passes.

Time passes.

Time passes.

Time passes.

Time passes.

Time passes.

Time passes.

Time passes.

Time passes.

Time passes.

Time passes.

Time passes.

Time passes.

Time passes.

Time passes.

Time passes.

Time passes.

10:30 am

>z.z.z.z.z.z.z.z.z.z.z.z.z.z.z.z.z.z.z.z.z.z.z.z.z.z.z.z.z.z
Time passes.

Time passes.

Time passes.

Time passes.

Time passes.

Time passes.

Time passes.

Time passes.

Time passes.

Time passes.

Time passes.

Time passes.

Time passes.

Time passes.

Time passes.

Time passes.

Time passes.

Time passes.

Time passes.

Time passes.

Time passes.

Time passes.

Time passes.

Time passes.

Time passes.

Time passes.

Time passes.

Time passes.

Time passes.

Time passes.

11:00 am

>z.z.z.z.z.z.z.z.z.z.z.z.z.z.z.z.z.z.z.z.z.z.z.z.z.z.z.z.z.z
Time passes.

Time passes.

Time passes.

Time passes.

Time passes.

Time passes.

Time passes.

Time passes.

Time passes.

Time passes.

Time passes.

Time passes.

Time passes.

Time passes.

Time passes.

Time passes.

Time passes.

Time passes.

Time passes.

Time passes.

Time passes.

Time passes.

Time passes.

Time passes.

Time passes.

Time passes.

Time passes.

Time passes.

Time passes.

Time passes.

11:30 am

>z.z.z.z.z.z.z.z.z.z.z.z.z.z.z.z.z.z.z.z.z.z.z.z.z.z.z.z.z.z
Time passes.

Time passes.

Time passes.

Time passes.

Time passes.

Time passes.

Time passes.

Time passes.

Time passes.

Time passes.

Time passes.

Time passes.

Time passes.

Time passes.

Time passes.

Time passes.

Time passes.

Time passes.

Time passes.

Time passes.

Time passes.

Time passes.

Time passes.

Time passes.

Time passes.

Time passes.

Time passes.

Time passes.

Time passes.

Time passes.

12:00 pm

>z.z.z.z.z.z.z.z.z.z.z.z.z.z.z.z.z.z.z.z.z.z.z.z.z.z.z.z.z.z
Time passes.

Time passes.

Time passes.

Time passes.

Time passes.

Time passes.

Time passes.

Time passes.

Time passes.

Time passes.

Time passes.

Time passes.

Time passes.

Time passes.

Time passes.

Time passes.

Time passes.

Time passes.

Time passes.

Time passes.

Time passes.

Time passes.

Time passes.

Time passes.

Time passes.

Time passes.

Time passes.

Time passes.

Time passes.

Time passes.

12:30 pm

>z.z.z.z.z.z.z.z.z.z.z.z.z.z.z.z.z.z.z.z.z.z.z.z.z.z.z.z.z.z
Time passes.

Time passes.

Time passes.

Time passes.

Time passes.

Time passes.

Time passes.

Time passes.

Time passes.

Time passes.

Time passes.

Time passes.

Time passes.

Time passes.

Time passes.

Time passes.

Time passes.

Time passes.

Time passes.

Time passes.

Time passes.

Time passes.

Time passes.

Time passes.

Time passes.

Time passes.

Time passes.

Time passes.

Time passes.

Time passes.

1:00 pm

>z.z.z.z.z.z.z.z.z.z.z.z.z.z.z.z.z.z.z.z.z.z.z.z.z.z.z.z.z.z
Time passes.

Time passes.

Time passes.

Time passes.

Time passes.

Time passes.

Time passes.

Time passes.

Time passes.

Time passes.

Time passes.

Time passes.

Time passes.

Time passes.

Time passes.

Time passes.

Time passes.

Time passes.

Time passes.

Time passes.

Time passes.

Time passes.

Time passes.

Time passes.

Time passes.

Time passes.

Time passes.

Time passes.

Time passes.

Time passes.

1:30 pm

>z.z.z.z.z.z.z.z.z.z.z.z.z.z.z.z.z.z.z.z.z.z.z.z.z.z.z.z.z.z
Time passes.

Time passes.

Time passes.

Time passes.

Time passes.

Time passes.

Time passes.

Time passes.

Time passes.

Time passes.

Time passes.

Time passes.

Time passes.

Time passes.

Time passes.

Time passes.

Time passes.

Time passes.

Time passes.

Time passes.

Time passes.

Time passes.

Time passes.

Time passes.

Time passes.

Time passes.

Time passes.

Time passes.

Time passes.

Time passes.

2:00 pm

>z.z.z.z.z.z.z.z.z.z.z.z.z.z.z.z.z.z.z.z.z.z.z.z.z.z.z.z.z.z
Time passes.

Time passes.

Time passes.

Time passes.

Time passes.

Time passes.

Time passes.

Time passes.

Time passes.

Time passes.

Time passes.

Time passes.

Time passes.

Time passes.

Time passes.

Time passes.

Time passes.

Time passes.

Time passes.

Time passes.

Time passes.

Time passes.

Time passes.

Time passes.

Time passes.

Time passes.

Time passes.

Time passes.

Time passes.

Time passes.

2:30 pm

>z.z.z.z.z.z.z.z.z.z.z.z.z.z.z.z.z.z.z.z.z.z.z.z.z.z.z.z.z.z
Time passes.

Time passes.

Time passes.

Time passes.

Time passes.

Time passes.

Time passes.

Time passes.

Time passes.

Time passes.

Time passes.

Time passes.

Time passes.

Time passes.

Time passes.

Time passes.

Time passes.

Time passes.

Time passes.

Time passes.

Time passes.

Time passes.

Time passes.

Time passes.

Time passes.

Time passes.

Time passes.

Time passes.

Time passes.

Time passes.

3:00 pm

>z.z.z.z.z.z.z.z.z.z.z.z.z.z.z.z.z.z.z.z.z.z.z.z.z.z.z.z.z.z
Time passes.

Time passes.

Time passes.

Time passes.

Time passes.

Time passes.

Time passes.

Time passes.

Time passes.

Time passes.

Time passes.

Time passes.

Time passes.

Time passes.

Time passes.

Time passes.

Time passes.

Time passes.

Time passes.

Time passes.

Time passes.

Time passes.

Time passes.

Time passes.

Time passes.

Time passes.

Time passes.

Time passes.

Time passes.

Time passes.

3:30 pm

>z.z.z.z.z.z.z.z.z.z.z.z.z.z.z.z.z.z.z.z.z.z.z.z.z.z.z.z.z.z
Time passes.

Time passes.

Time passes.

Time passes.

Time passes.

Time passes.

Time passes.

Time passes.

Time passes.

Time passes.

Time passes.

Time passes.

Time passes.

Time passes.

Time passes.

Time passes.

Time passes.

Time passes.

Time passes.

Time passes.

Time passes.

Time passes.

Time passes.

Time passes.

Time passes.

Time passes.

Time passes.

Time passes.

Time passes.

Time passes.

4:00 pm

>z.z.z.z.z.z.z.z.z.z.z.z.z.z.z.z.z.z.z.z.z.z.z.z.z.z.z.z.z.z
Time passes.

Time passes.

Time passes.

Time passes.

Time passes.

Time passes.

Time passes.

Time passes.

Time passes.

Time passes.

Time passes.

Time passes.

Time passes.

Time passes.

Time passes.

Time passes.

Time passes.

Time passes.

Time passes.

Time passes.

Time passes.

Time passes.

Time passes.

Time passes.

Time passes.

Time passes.

Time passes.

Time passes.

Time passes.

Time passes.

4:30 pm

* * *

The Maltese Corsairs
An Interactive Fiction
Release 1 / Serial number 100218 / Inform 7 build 5Z71 (I6/v6.31 lib 6/12N) SD

Hold
On some occasions, the hold is an empty cavern full of not much beside the sound of waves.  Not this week, though.  Crates and crates--of cinnamon, of all things--line the bulkheads, leaving only a narrow path aft to the brig from the stair leading up to the crew quarters.

>z
Time passes.

>i
You are carrying nothing.

9:02 am

>undo
Hold
[Previous turn undone.]

9:01 am

>l
Hold
Crates and crates--of cinnamon, of all things--line the bulkheads, leaving only a narrow path aft to the brig from the stair leading up to the crew quarters.

9:02 am

>l
Hold
Crates and crates--of cinnamon, of all things--line the bulkheads, leaving only a narrow path aft to the brig from the stair leading up to the crew quarters.

9:03 am

>l
Hold
Crates and crates--of cinnamon, of all things--line the bulkheads, leaving only a narrow path aft to the brig from the stair leading up to the crew quarters.

9:04 am

>z.z.z.z.z.z.z.
Time passes.

Time passes.

Time passes.

Time passes.

Time passes.

Time passes.

Time passes.

9:11 am

>z.z.z.z.z.z.z.z
Time passes.

Time passes.

Time passes.

Time passes.

Time passes.

Time passes.

Time passes.

Time passes.

9:19 am

>z.z.z.z.z.z.z.z
Time passes.

Time passes.

Time passes.

Time passes.

Time passes.

Time passes.

Time passes.

Time passes.

9:27 am

>z.z.z.z.z.z.z.z
Time passes.

Time passes.

Time passes.

Time passes.

Time passes.

Time passes.

Time passes.

Time passes.

9:35 am

>z.z.z.z.z.z.z.z
Time passes.

Time passes.

Time passes.

Time passes.

Time passes.

Time passes.

Time passes.

Time passes.

9:43 am

>z.z.z.z.z.z.z.z
Time passes.

Time passes.

Time passes.

Time passes.

Time passes.

Time passes.

Time passes.

Time passes.

9:51 am

>z.z.z.z.z.z.z.z
Time passes.

Time passes.

Time passes.

Time passes.

Time passes.

Time passes.

Time passes.

Time passes.

9:59 am

>z
Time passes.

10:00 am

>z
Time passes.

10:01 am

* * *

>z
Time passes.

>z
Time passes.

I beg your pardon?

9:05 am

* * *

>z
Time passes.

9:06 am

>z
Time passes.

9:07 am

>z.z.z.z.z.z.z.z.z.z.z.z.z.z.z.z.z
Time passes.

Time passes.

Time passes.

Time passes.

Time passes.

Time passes.

Time passes.

Time passes.

Time passes.

Time passes.

Time passes.

Time passes.

Time passes.

Time passes.

Time passes.

Time passes.

Time passes.

9:24 am

>z
Time passes.

9:25 am

>z
Time passes.

9:26 am

>z
Time passes.

9:27 am

>z
Time passes.

9:28 am

>z
Time passes.

9:29 am

>z
Time passes.

9:30 am

>z
Time passes.

9:31 am

* * *

>z
Time passes.

>z.z.z.z.z.z.z.z.
Time passes.

Time passes.

Time passes.

Time passes.

Time passes.

Time passes.

Time passes.

Time passes.

9:09 am

>z.z.z.z.z.z.z.z.
Time passes.

Time passes.

Time passes.

Time passes.

Time passes.

Time passes.

Time passes.

Time passes.

9:17 am

>z.z.z.z.z.z.z.z.
Time passes.

Time passes.

Time passes.

Time passes.

Time passes.

Time passes.

Time passes.

Time passes.

9:25 am

>z.z.z.z.z.z.z.z.
Time passes.

Time passes.

Time passes.

Time passes.

Time passes.

Time passes.

Time passes.

Time passes.

9:33 am

>z.z.z.z.z.z.z.z.
Time passes.

Time passes.

Time passes.

Time passes.

Time passes.

Time passes.

Time passes.

Time passes.

9:41 am

>z.z.z.z.z.z.z.z.
Time passes.

Time passes.

Time passes.

Time passes.

Time passes.

Time passes.

Time passes.

Time passes.

9:49 am

>z.z.z.z.z.z.z.z.
Time passes.

Time passes.

Time passes.

Time passes.

Time passes.

Time passes.

Time passes.

Time passes.

9:57 am

>z
Time passes.

9:58 am

>z
Time passes.

9:59 am

>z
Time passes.

10:00 am

* * *

>z
Time passes.

>z.z.z.z.z.z.z.z.z
Time passes.

Time passes.

Time passes.

Time passes.

Time passes.

Time passes.

Time passes.

Time passes.

Time passes.

>z.z.z.z.z.z.z.z.z
Time passes.

Time passes.

Time passes.

Time passes.

Time passes.

Time passes.

Time passes.

Time passes.

Time passes.

>z
Time passes.

>z.z.z.z.z.z.z.z.z.z
Time passes.

Time passes.

Time passes.

Time passes.

Time passes.

Time passes.

Time passes.

Time passes.

Time passes.

Time passes.

>z.z.z.z.z.z.z.z.z.zz
Time passes.

Time passes.

Time passes.

Time passes.

Time passes.

Time passes.

Time passes.

Time passes.

Time passes.

That's not a verb I recognize.

>z.z.z.z.z.z.z.z.z.z.z
Time passes.

Time passes.

Time passes.

Time passes.

Time passes.

Time passes.

Time passes.

Time passes.

Time passes.

Time passes.

Time passes.

>z.z.z.z.z.z.z.z.z.z
Time passes.

Time passes.

Time passes.

Time passes.

Time passes.

Time passes.

Time passes.

Time passes.

Time passes.

Time passes.

>z.z.z.z.z.z.z.z.z.z
Time passes.

Time passes.

Time passes.

Time passes.

Time passes.

Time passes.

Time passes.

Time passes.

Time passes.

Time passes.

* * *

The Maltese Corsairs
An Interactive Fiction
Release 1 / Serial number 100218 / Inform 7 build 5Z71 (I6/v6.31 lib 6/12N) SD

Hold
On some occasions, the hold is an empty cavern full of not much beside the sound of waves.  Not this week, though.  Crates and crates--of cinnamon, of all things--line the bulkheads, leaving only a narrow path aft to the brig from the stair leading up to the crew quarters.

>s
[You can't go that way, amico.  It looks like you can only go up and aft.]

>a
Brig
It's a small room, with a barred cell that takes up half of it.  The walls are a dingy white and the small lamp at the guard's desk doesn't do much to enliven the place.   We don't normally deal in prisoners, so most of the time brig duty is just a chance to sneak in an extra shift of sleep.

>l
Brig
It's a small room, with a cell that takes up half of it.

>enter cell
You can't see any such thing.

* * *

>a
Brig
It's a small room, with a barred cell that takes up half of it.  The walls are a dingy white and the small lamp at the guard's desk doesn't do much to enliven the place.   We don't normally deal in prisoners, so most of the time brig duty is just a chance to sneak in an extra shift of sleep.

>f
Hold

>verbose
The Maltese Corsairs is now in its "verbose" mode, which always gives long descriptions of locations (even if you've been there before).

>up
Crew Quarters
A row of hammocks line the berth deck along the starboard side, which curves to create a moderately open space.  A curtained alcove off the opposite side secludes the cannon master's bed from casual view. You still haven't been able to figure out why the captain won't set up cabins for everyone. 

If you need to hit the head, the door is on the fore wall; the mess is aft, and stairs lead down to the hold and up to the Cannons.

>f
Head
A place for doing one's business.  The less said about the condition of this room, the better.  The exit is aft.

>a
Crew Quarters
A row of hammocks line the berth deck along the starboard side, which curves to create a moderately open space.  A curtained alcove off the opposite side secludes the cannon master's bed from casual view.

If you need to hit the head, the door is on the fore wall; the mess is aft, and stairs lead down to the hold and up to the Cannons.

>a
Mess
A pair of long tables are the main feature of the mess. You can probably count on one hand the number of times the whole crew has sat down to eat together, though. Rock generally leaves a plate or pot of something out for folk, and today is no exception.

>a
Galley
The ship's kitchen is not very large, and the presence of the cook generally leaves it much more cramped.  Cabinets line the upper and lower walls, and a small bench sits by the entrance, fore.

>a
[You can't go that way, amico.  It looks like you can only go fore.]

>f
Mess
A pair of long tables are the main feature of the mess. Rock generally leaves a plate or pot of something out for folk, and today is no exception.

>f
Crew Quarters
A row of hammocks line the berth deck along the starboard side, which curves to create a moderately open space.  A curtained alcove off the opposite side secludes the cannon master's bed from casual view.

If you need to hit the head, the door is on the fore wall; the mess is aft, and stairs lead down to the hold and up to the Cannons.

>u
Cannons
The gun deck is long with a low ceiling, lit only by dim shafts of sunlight falling on rows of cannons aimed outwards.

Stairs lead down to the crew quarters and up to the deck.

>u
Deck

>u
Crows' Nest

>u
[You can't go that way, amico.  It looks like you can only go down.]

>d
Deck

>d
Cannons
The gun deck is long with a low ceiling, lit only by dim shafts of sunlight falling on rows of cannons aimed outwards.

Stairs lead down to the crew quarters and up to the deck.

>u
Deck

>n
[We ain't sailin' compass-wise, amico.  It's starboard, port, fore, and aft when we're aboard ship, and it looks like you can go up, down, inside, starboard, fore, and aft from here.]

>in
Captain's Hall

>in
[You can't go that way, amico.  It looks like you can only go outside, starboard, port, and fore.]

* * *

>s
[You can't go that way, amico.  It looks like you can only go up and aft.]

>aft
Brig
It's a small room, with a barred cell that takes up half of it.  The walls are a dingy white and the small lamp at the guard's desk doesn't do much to enliven the place.   We don't normally deal in prisoners, so most of the time brig duty is just a chance to sneak in an extra shift of sleep.

>fore
Hold

>verbose
The Maltese Corsairs is now in its "verbose" mode, which always gives long descriptions of locations (even if you've been there before).

>l
Hold
Crates and crates--of cinnamon, of all things--line the bulkheads, leaving only a narrow path aft to the brig from the stair leading up to the crew quarters.

>up
Crew Quarters
A row of hammocks line the berth deck along the starboard side, which curves to create a moderately open space.  A curtained alcove off the opposite side secludes the cannon master's bed from casual view. You still haven't been able to figure out why the captain won't set up cabins for everyone. 

If you need to hit the head, the door is on the fore wall; the mess is aft, and stairs lead down to the hold and up to the Cannons.

>up
Cannons
The gun deck is long with a low ceiling, lit only by dim shafts of sunlight falling on rows of cannons aimed outwards.

Stairs lead down to the crew quarters and up to the deck.

>up
Deck
The sea stretches out in every direction... but you're standing on the deck of the Joli, which feels cramped by comparison. (You never did get the hang of how much smaller life aboard ship is.) The entrance to the captain's hall is aft, and the deck extends in the opposite direction to the fo'c'sle.  You could also climb up to the crows' nest, or go down to the Cannons.

>fore
Forecastle
You could probably sit here and watch the ship plow the Mediterranean all day, but you likely have other things to do.

>aft
Deck
The sea stretches out in every direction... but you're standing on the deck of the Joli, which feels cramped by comparison. The entrance to the captain's hall is aft, and the deck extends in the opposite direction to the fo'c'sle.  You could also climb up to the crows' nest, or go down to the Cannons.

>starboard
Lifeboat
It's one of those little boats one hopes one never has to find oneself needing... and not just because of how cramped it'd be with most of the crew crammed into it.  On a sunny day off, though, it's just another place to take in some shut-eye.

>port
Deck
The sea stretches out in every direction... but you're standing on the deck of the Joli, which feels cramped by comparison. The entrance to the captain's hall is aft, and the deck extends in the opposite direction to the fo'c'sle.  You could also climb up to the crows' nest, or go down to the Cannons.

>s
Lifeboat
It's one of those little boats one hopes one never has to find oneself needing... and not just because of how cramped it'd be with most of the crew crammed into it.  On a sunny day off, though, it's just another place to take in some shut-eye.

>p
Deck
The sea stretches out in every direction... but you're standing on the deck of the Joli, which feels cramped by comparison. The entrance to the captain's hall is aft, and the deck extends in the opposite direction to the fo'c'sle.  You could also climb up to the crows' nest, or go down to the Cannons.

>aft
Captain's Hall
The captain generally keeps all his equipment here, more likely than not stacked at random on the grand table at the center of the room.  The walls are also bedecked with miscellany finds from the ship's travels, including a shelf with a radio that won't be useful for another hundred years or so.  The captain's quarters are to starboard and the first mate's to port.

>in
[You can't go that way, amico.  It looks like you can only go outside, starboard, port, and fore.]

>port
First Mate's Quarters
Frostbite's cabin is full of piles of crates, chests, and boxes--so much so it's hard to see where he sleeps...if he sleeps at all.

>out
Captain's Hall
The captain generally keeps all his equipment here, more likely than not stacked at random on the grand table at the center of the room.  The walls are also bedecked with miscellany finds from the ship's travels, including a shelf with a radio that won't be useful for another hundred years or so.  The captain's quarters are to starboard and the first mate's to port.

>s
Captain's Quarters
In contrast to his hall, Bluebeard's quarters are spartan and tidy.  A hammock hangs by a porthole starboard, and the chest with the captain's effects sits beside it.

>l me
I only understood you as far as wanting to look.

>l
Captain's Quarters
In contrast to his hall, Bluebeard's quarters are spartan and tidy.  A hammock hangs by a porthole starboard, and the chest with the captain's effects sits beside it.

* * *

The Maltese Corsairs
An Interactive Fiction
Release 1 / Serial number 100218 / Inform 7 build 5Z71 (I6/v6.31 lib 6/12N) SD

Hold
On some occasions, the hold is an empty cavern full of not much beside the sound of waves.  Not this week, though.  Crates and crates--of cinnamon, of all things--line the bulkheads, leaving only a narrow path aft to the brig from the stair leading up to the crew quarters.

>d
[I can't go that way, amico.  It looks like I can only go up and aft.]

>aft
Brig

>fore
Hold

>a
Brig

>f
Hold

>u
Crew Quarters

>f
Head

>a
Crew Quarters

>a
Mess

>a
Galley

>a
[I can't go that way, amico.  It looks like I can only go fore.]

>f
Mess

>e
[We ain't sailin' compass-wise, amico.  It's starboard, port, fore, and aft when we're on board, and it looks like I can go fore and aft from here.]

* * *

The Maltese Corsairs
An Interactive Fiction
Release 1 / Serial number 100218 / Inform 7 build 5Z71 (I6/v6.31 lib 6/12N) SD

Hold
On some occasions, the hold is an empty cavern full of not much beside the sound of waves.  Not this week, though.  Crates and crates--of cinnamon, of all things--line the bulkheads, leaving only a narrow path aft to the brig from the stair leading up to the crew quarters.

>e
[We ain't got a compass, sami.  It's up, down, inside, outside, starboard, port, fore, and aft here.]